0
                                                                                
                                                                                
               ######                  #######                                  
               #····#          #####   #######                  ######          
               #····#       ########   #######           #############          
               #·####       #····###   #·····#           #####····####          
              ##·######     #·##·###   #·###·#           #···········#          
              ##·###### #####·######   #·# #·#######     #·########··#          
              ##·###### #·····#     ####·# #·#############·#   ####··#          
              #·····### ####··#     #····# #·#####····####·#   ####··#          
              ####··###  ###··###   #·#### #···············#   ####··#          
             #####··##   ###··###  ##·##   #####··##########   #·····#          
             #####··##   ###··###  ##·##      ##··#            ####··#          
             #####··##   #····###  #··##      #···#               #··######     
             #·······#   ###·####  #####      #####               #··######     
             #######·#     #·#                                    #··######     
                   #·####  #·#          #########        ####     #·······#     
                   #·####  #·####################        ######## ######··#     
                   #···##  #·······###····#######        #·····##     ##··###   
                   ###·##  ####····###··········#        #··##·########···###   
                     #·#      ####····@###·####·#    #####··##·····#####··###   
                     #·#######   ####### #·####·#    #······######··####··##### 
                     #····#######        #······#    #······#    #··####··##### 
                     #····##····#        #··##··#    #·###### ####··# ##··##### 
                     ####····##·#      ###··##··######·##     #·····# #····#### 
                        #######·##########··##······##·##     ##··### ###··#### 
                              #·············#######····##      #··#######··#    
                              ###############     #######      #·····####··#    
                                                               #####·······#    
                                                                   #########    
